1111110000
0000010121
0000010101
0000013101
0000011101
0000000001
0000011113
0000110000
0000100312
0000111104
