1111113333
3333343333
00o0050000
00o0060000
00o00711o1
0010000004
00n0011113
00oo110003
0000100312
000011110w
