1111000000
0001001111
0111001000
1100001001
1001001201
1011000001
1110011111
0000010000
0000020111
0000111104
