1000000000
2000000560
30000014o0
o0660014o0
50611014o0
5001666602
6001611232
7001614000
0000025000
000011670w
